WWWWWWWWWWWWWWWWW
W W W       W W W
W W W WWW WWW W W
W     W     W   W
W WWWWWWW W W WWW
W W     W W   W W
WWWWW WWWWW WWW W
W  EW W   W     W
WWW W WWW W WWWWW
W         W W   W
WWWWW WWW W W WWW
W     WS    W W W
W W WWWWWWW W W W
W W W           W
WWWWW W W W W WWW
W     W W W W   W
WWWWWWWWWWWWWWWWW
