WWWWWWWWWWWWWWWWW
W             W W
WWW W WWWWWWW W W
W   W   W W W W W
WWW WWWWW W WWW W
W     W W       W
WWWWW W W W WWWWW
W       W W W   W
WWW WWWWW WWW WWW
W            E  W
WWW WWWWWWW WWW W
W         W   WSW
WWW WWW W WWWWWWW
W     W W       W
WWW W W WWW WWW W
W   W W   W   W W
WWWWWWWWWWWWWWWWW
