         W
WWWWWW WWW
   E     W
WWWWWW WWW
 W W     W
 W W W WWW
 W W W   W
 W WWW WWW
       S W
WWWWWWWWWW
