WWWWWWWWWWWWWWW
W     W W   W W
WWWWW WSWWW W W
W W W     W W W
W W W WWWWW W W
W   W   W W   W
WWW W WWW W WWW
W W     W     W
W WWWWW WWW WWW
W W   W   W   W
W WWW W WWW WWW
W   W   W   W W
W W WWW WWW W W
W W      E    W
WWWWWWWWWWWWWWW
