WWWWWWWWWWWWWWWWWWWWWWWWW
WSWD    W               W
W WWW WWW WWW WWWWWWWWW W
W   W   W   W W       W W
WWW WWW WWW WKWWW W WWW W
W W   W     W   W W   W W
W WWW W WWWWWWW WWW W W W
W W   W   W   W   W W   W
W W WWWWW W W WWW W WWWWW
W W   W     W W   W W   W
W WWW WWWWWWWWW WWW W W W
W D W W         W W  KWDW
WWW W W WWWWWWWWW WWWWW W
W   W   W W       W     W
W WWWWWWW W WWWWW W WWWWW
W W       W W W D W     W
W W WWW WWW W W WKWWWWW W
W   W W     W W W W    DW
W WWW WWWWWWW W WWW WWWWW
W             W        EW
WWWWWWWWWWWWWWWWWWWWWWWWW
