WWWWWWWWWW
W W       
W WWW WWWW
W W   W W 
W W WWW W 
W     W   
W W W W W 
W W W   W 
WWWWW W WW
WS E  W   
