W   W         W
W WWW WWWWWWW W
W           W W
W WWWWWWWWWWWWW
W   W W W   WSW
W WWW W WWW W W
W             W
W W W WWWWW WWW
W W W   W     W
W W W WWW W WWW
W W W   W W   W
W WWW WWW W W W
W   W WE  W W W
W W WWWWW WWW W
W W     W   W W
