WWWWWWWWWW
WS       W
W WWW WW W
W W   W  W
W W WWW WW
W W W    W
W WWWW W W
W   W  WXW
WWWWWWWWWW