 W     W W     
 W WWWWW W WWW 
   W W       W 
 W W W WWWWWWWW
 W       W     
WWWWWW W W WWWW
       W       
WWWWWW WWWWWWWW
           W W 
 WWW WWWWWWW WE
 W       W    S
WWWW WWW W WWWW
       W       
 WWWWW WWWWW W 
 W         W W 
