WWWWWWWWWWWWWWWWWWWWWWWWW
 W   W   W     W   W     
 W WWW WWW WWW W WWW WWWW
 W     W   W W W   W   W 
 WWW WWWWW W WWW WWW WWW 
   W     W               
WW W WWWWW WWW WWWWW W W 
 W W W       W W   W W W 
 W W W WWWWW WWW WWWWW WW
     W W   W     W   W   
 WWWWW W W W W WWW WWW WW
     W W W W W W     W   
 W WWW W WWW WWW WWW WWW 
 W     E   W       W W W 
WW WWWWWWWWW WWW WWWWW WW
         W W   W         
 WWW W W W WWWWWWW WWWWWW
 W   W W      SW W   W W 
WWWW WWWWWWW WWW WWW W W 
         W         W     
 W WWW W W W W W WWWWWWWW
 W   W W W W W W   W W W 
 WWW W W W WWW WWW W W W 
   W W W W   W W         
WWWWWWWWWWWWWWWWWWWWWWWWW
