WWWWWWWWWWWWWWW
W W W S W W W W
W W WWW W W W W
W       W W W W
W W WWW W W W W
W W W   W W W W
W WWWWW W W W W
W W W W W W   W
WWW W W W WWW W
W     W   W   W
W W WWW W W WWW
W W     W     W
WWW WWW W WWW W
W E   W W W   W
WWWWWWWWWWWWWWW
