WWWWWWWWWWWW
 W W W     W
 WSW WWW W W
     E W W W
 WWWWW W W W
 W W W   W W
 W W W W W W
 W     W W W
WW W W WWW W
   W W W W W
 WWWWW W WWW
   W       W
