WWWWWWWWWWWWWWWWWWW
W     W   W W     W
WWWWW WWW W W WWWWW
W W   W   W     W W
W WWW WWW WWWWW W W
W     W   W W W   W
W WWWWWWW W W W WWW
W W     W       W W
W WWWWW WWWWW WWW W
W     W         W W
WWW WWWWWWW WWWWW W
W W     W W     W W
W W W W W W WWW W W
W   W W       W W W
W W WWW W WWW WWW W
W W W  EW W       W
WWW WWW W W W W W W
W   W   WSW W W W W
WWWWWWWWWWWWWWWWWWW
